################
#P.....#......X#
#.###..#..##...#
#....#....#..E.#
#.##.####.#....#
#......#..#....#
#.####.#..#.##.#
#......#..#....#
###.####..#.####
#....E.#..#....#
#..##..#..#....#
#..#...####.##.#
#..#...........#
#..####.####...#
#..............#
################
