####################
#P....#.....K...E.X#
#..##.#.#####.###..#
#..#..#.....#...#..#
#..#..#####.#.#.#..#
#..#...E....#B#.#E.#
#..#######.#...#...#
#..^^....#.#.#.#####
###.####.#.#.#....E#
#b..####.#.#.###...#
#.#.####.#^#...#E..#
#.#.####.#.###.#.###
#.#.....d#...#.#...#
#E###^####.#^^.#K..#
#.....^^....#...D.b#
####################
