############
#P.....#..X#
#..##..#...#
#.....E#...#
###..###...#
#....#.....#
#b.E.####E.#
#^^..#..K..#
#...^B.....#
############
