############
#P.....#..X#
#..##..#...#
#..K..E#...#
###..###...#
#....#.....#
#..E.#.##..#
#....#..K..#
#......E...#
############
