########
#P..K.X#
#.##..E#
#...d..#
#.####D#
#....E.#
#E..^^.#
########
