############
#P.....#..X#
#..##..#...#
#.....E#...#
###..###...#
#....#.....#
#d.E.####E.#
#^^..#..K..#
#...^D.....#
############
