################
#P.....#......X#
#.###..#..##...#
#....#....#..E.#
#.##.####.#....#
#.b....#..#E...#
######D#..#d##.#
#......#..#....#
###.####..#.####
#....E.#..#..E.#
#..##..#..#....#
#..#...####.##.#
#..#.....^^....#
#..####^^^######
#..^^.B...K....#
################
