####################
#P....#.....K...E.X#
#..##.#.#####.###..#
#..#..#.....#...#..#
#..#..#####.#.#.#..#
#..#...E....#B#.#..#
#..#######.#...#...#
#..^^....#.#.#.#####
###.####.#.#.#....E#
#b..####.#.#.###...#
#.#.####.#^#...#...#
#.#.####.#.###.#.###
#.#.....d#...#.#...#
#E###^####.#...#K..#
#...........#...D..#
####################
