####################
#P....#.....K...E.X#
#..##.#.#####.###..#
#..#..#.....#...#..#
#..#..###.#.#.#.#..#
#..#......#.#.#.#..#
#..#######.#.#.#...#
#........#.#.#.#####
###.####.#.#.#.....#
#...#..#.#.#.###...#
#.#.#..#.#.#...#...#
#.#.####.#.###.#.###
#.#......#...#.#...#
#E########.#.#.#K..#
#...........#......#
####################
