####################
#P....#.....K...E.X#
#..##.#.#####.###..#
#..#..#.....#...#..#
#..#..#####.#.#.#..#
#..#...E....#.#.#..#
#..#######.#...#...#
#..^^....#.#.#.#####
###.####.#.#.#....E#
#...####.#.#.###...#
#.#.####.#^#...#...#
#.#.####.#.###.#.###
#.#......#...#.#...#
#E###^####.#...#K..#
#...........#......#
####################
