################################
#P.....#......#.....K....#....X#
#..###.#.####.#.#######.#.##.#.#
#..#...#..E.#.#.......#.#....#.#
#..#.#####..#.#.#####.#.###..#.#
#..#.....#..#.#.#...#.#...E.#..#
#..#####.#..#.#.#.#.#.#####.#..#
#......#.#..#.#.#.#.#......#.#.#
####.#.#.####.#.#.#.#####.#..#.#
#....#.#......#.#.#.....#.#..#.#
#.####.########.#.#####.#.#..#.#
#......#......#....E..#.#.#.#..#
#.######.####.#.#####.#.#.#.#..#
#......#....#.#.....#.#.#.#..#.#
#E####.####.#.#####.#.#.#.#..#.#
#....#......#.......#.#.#..#.#.#
#.#...#############.#.#.#..#.#.#
#..##...............#.#....#...#
#.....#############...####.E...#
################################
